################
#.H.&&&&.E...###
#.H.&&&##.E....#
#.&&&..EHH##H.&#
################